000000000000000000000000000000
000000000000000000000000000000
000000000000000000000000000000
000000000000000000000000000000
000000000000000000000000000000
000000000000000000000000000000
000000000000000000000000000000
000000000000222222220000000000
000000000000211111120000000000
000000000000211111120000000000
000000000000211111120000000000
000000000000211111120000000000
000000002222212222222000000000
000000002111111111112000000000
000000002111211111112222222220
000000002111211111112111111120
000000002111211111111111111120
000000002222211111112111111120
000000000000211111112111111120
000000000002222222122111111120
000000000002111111122222222220
000000000002111111120000000000
000000000002111111120000000000
000000000002111111120000000000
000000000002111111120000000000
000000000002111111120000000000
000000000002222222220000000000
000000000000000000000000000000
000000000000000000000000000000
000000000000000000000000000000
