000000000000000000000000000000
000000000000000000000000000000
000000000000000000000000000000
000000000000000000000000000000
000000000000000022222220000000
000000000000000021111120000000
000000000000000021111120000000
000000000000000021311120000000
000000000000000021111120000000
000000000000000021111120000000
000000000000000021111120000000
000000222222200021111120000000
000000211111222221222220000000
000000211111211111120000000000
000000211111211111120000000000
000000211111211111120000000000
000000211111211111122222222000
000000211111211111111111112000
000000211111111111121111112000
000000222222222221221111112000
000000000002111111222222222000
000000000002111111200000000000
000000000002111111200000000000
000000000002222222200000000000
000000000000000000000000000000
000000000000000000000000000000
000000000000000000000000000000
000000000000000000000000000000
000000000000000000000000000000
000000000000000000000000000000
