000000000000000000000000000000
000000000000000000000000000000
000000000000000000000000000000
000000000000000000000000000000
000000000000000000000000000000
000000000000000000000000000000
000000000000000000000000000000
000000000000022222222000000000
000000000000021111112000000000
000000000000021111112000000000
000000000000021111112000000000
000000002222221111112000000000
000000002111221222222000000000
000000002111211112222222220000
000000002111111112111111120000
000000002111211112111111120000
000000002111211111111111120000
000000002222222122111111120000
000000002111111122111111120000
000000002111111122222222220000
000000002111111120000000000000
000000002222222220000000000000
000000000000000000000000000000
000000000000000000000000000000
000000000000000000000000000000
000000000000000000000000000000
000000000000000000000000000000
000000000000000000000000000000
000000000000000000000000000000
000000000000000000000000000000
