000000000000000000000000000000
000000000000000000000000000000
000000000000000000000000000000
000000000000000000000000000000
000000000000000000000000000000
000000000000000000000000000000
000000000000000000000000000000
000000000000000000000000000000
000000000000002222222200000000
000000000000002111111200000000
000000000000002111111200000000
000000000000002111111200000000
000002222222222122222200000000
000002111111211120000000000000
000002111111211120000000000000
000002111111211122222222000000
000002111111111121111112000000
000002111111211121111112000000
000002222222211111111112000000
000000022222221222222222000000
000000021111111200000000000000
000000021111111200000000000000
000000021111111200000000000000
000000022222222200000000000000
000000000000000000000000000000
000000000000000000000000000000
000000000000000000000000000000
000000000000000000000000000000
000000000000000000000000000000
000000000000000000000000000000
