000000000000000000000000000000
000000000000000000000000000000
000000000000000000000000000000
000000000000000000000000000000
000000000000000000000000000000
000000000000000000000000000000
000000000000000002222200000000
000000000000000002311200000000
000000000000000002111200000000
000000000000000002111200000000
000000000000000002111200000000
000000000000000002111200000000
000000222222222222122200000000
000000211111211111120000000000
000000211111211111120000000000
000000211111211111120000000000
000000211111211111122222000000
000000211111111111111112000000
000000222222211111121112000000
000000000000222221221112000000
000000000000211111222222000000
000000000000211111200000000000
000000000000211111200000000000
000000000000222222200000000000
000000000000000000000000000000
000000000000000000000000000000
000000000000000000000000000000
000000000000000000000000000000
000000000000000000000000000000
000000000000000000000000000000
